11111111
1E0000P1
10000001
11111111